ronic — mironic = milonic 266 rpet - marpet

la pâte: "Kakalamkam a miala to tolaay a sato no moki, rom'een a misaga' to ’pag" G" 18/6 Vite. P9 "'15

trois mesures de ﬂeur de farine et fais des galettes.

ronirom - karonirom arbre à épines qui sert à fabriquer le "nlahod".

rono cotisation : (que chaque famille doit verser à l’occasion des fêtes de la moisson _).

ronog carpe (poisson).

ropadoay - maropadoay {N} camarade...

roparop = riparip frotter oignon et sel et manger cru.

ropas = lopas pêcher (fruit); bibassier: Noix d’arec ({N}.

ropay - miropay aplanir en bouchant les trous .' Miropay to ilay: apIanir les mottes. - O

raropayen k0 sra a masalalan: arranger une route.

ropini' - miropini' to fokes = Iopini' se faire une belle chevelure; tresser (cheveux).

ropna' - {F} = 'opic mouillé.

'ror - mi'ror ronﬂer (feu).

'ror - misa'ror soufﬂer sur le feu.

'ror - sa'ror soufﬂet pour le feu.

'ror — {F} = mido'doc hériter...

rora'cos = ra'cos péché.

rorag mûrier à papier: bi-ussonetia papynfera.

roray souci : o roray no hkal: les soucis du monde.

roray - maroray avoir des soucis: maroray amihilateg: avoir des soucis, des szg'etsd’inquiétude ;
être fatigué : Maroray ko tireg ako.‘ je suisfati gué physiquement. Adihay ko, rarorayan nofaloco' ako:

j'ai beaucoup de sujets defatigue. — Aka pipa/(ararcg‘ takowanan: ne mefatigue: pas.

rorayan - narorayan fatigue.

roric - mipororic {T} = ronic enrouler, rouler (des légumes à faire du "kiro").

rorih — marorih inﬂammation de la peau : (par urine, sueur, la marche).

roriyac = torirac glisser...

rorod — <1 > copie; imitation.

rorod - <2> recherche: (aller aufond d’une enquête ).

rorod - <3> lieu propice d'un débarquement.

rorod - mirorod avoir une maladie de caractère héréditaire.

rorodan — pirorodan modèle; exemple; heure ofﬁcielle.

rorog gerbe s niroro an ; botte: aquet; touffe de roseaux .' "A Iaen k0 ccagv a rorog na hiso

hananav a taloa’ a micno i ci paroay a Âgvsig t0 rmes no siri” Ex 1.3/12 Vous prendre: une touﬁ’e d’Ærsope.

vous la trempere: dans Ie sang de l’agneau.

roroh = rorox vieux chaume d'un toit utilisé à nouveau.

roroh - miroroh blâmer, donner un blâme ; s'en prendre à quelqu'un.

'ros = 'Ios courant d'eau entraînant les objets.

rosarod - sarosarod = sarosaros râpe à patates; scie.

rosaros - mirosaros scier.

rosaros - sarosaros scie 

rosros - mirosros {N} tailler le bois.

rotar - {N} = ronag mare à buﬂles, à cochons.

rotarot = ronic malaxer les légumes ; broyer l'encre; frotter les habits sur une planche: 

rotay - marotay {F} fourbu.

rotic - mirotic = mlgayar to romi'ad ajourner...

roto sac à dos.

roto - maroto être porté sur le dos: symbole d’un jeune suspendant son sac dans une maison pour

montrer qu’il est intéressé par la jeune ﬁlle de la maison.

rotok = korto = larocaros = koga no lotok igname: dioscorea alata.

rowak anguille.

rowis = ro'ls éléments liquides du corps (larmes, sueur, sang).

royaroy - {F} = kakaya' long.

royat — miroyat s'étirer au lever. _

royayaw - maro ayaw {FT} = marlhahoy penché de côté.

rpar - mirpar {Sî’= krar aplanir... ,

rpat déchirure de blessure fermée ; couture décousue.

rpat - marpat déchiré en morceaux (papier, matériel) : maipat k0 koliciw.

rpel = rpet saisir...

rpet - marpet pris; arrêté : saisi :Marpet no saﬁtay ci Yiso a mapalit: Jésus est saisi par les

 

Ropas

